10 10
2 2
8 8
HHHHHHHHHH
HH H HHH H
H  H H   H
H HH H HHH
H HH H HHH
H HH H HHH
H      H H
HHH H HH H
HHH H    H
HHHHHHHHHH
